{
  "comment": "Stage grid shapes for Stages mode. 1 = active cell, 0 = inactive (dead space). Each row is one row of the 6x6 grid top-to-bottom. Edit freely — no Lua needed.",

  "1": [
    [1,1,1,1,1,1],
    [1,1,1,1,1,1],
    [1,1,1,1,1,1],
    [1,1,1,1,1,1],
    [1,1,1,1,1,1],
    [1,1,1,1,1,1]
  ],

  "2": [
    [0,0,1,1,0,0],
    [0,1,1,1,1,0],
    [1,1,1,1,1,1],
    [1,1,1,1,1,1],
    [0,1,1,1,1,0],
    [0,0,1,1,0,0]
  ],

  "3": [
    [0,0,1,1,0,0],
    [0,0,1,1,0,0],
    [1,1,1,1,1,1],
    [1,1,1,1,1,1],
    [0,0,1,1,0,0],
    [0,0,1,1,0,0]
  ],

  "4": [
    [1,1,1,1,0,0],
    [1,1,1,1,1,0],
    [1,1,1,1,1,1],
    [1,1,1,1,1,1],
    [0,1,1,1,1,1],
    [0,0,1,1,1,1]
  ],

  "5": [
    [1,1,1,1,1,1],
    [1,1,0,0,1,1],
    [1,1,0,0,1,1],
    [1,1,0,0,1,1],
    [1,1,0,0,1,1],
    [1,1,1,1,1,1]
  ],

  "6": [
    [0,1,1,1,1,0],
    [1,1,1,1,1,1],
    [1,1,0,0,1,1],
    [1,1,0,0,1,1],
    [1,1,1,1,1,1],
    [0,1,1,1,1,0]
  ],

  "7": [
    [1,1,0,0,1,1],
    [1,1,0,0,1,1],
    [1,1,1,1,1,1],
    [1,1,1,1,1,1],
    [1,1,0,0,1,1],
    [1,1,0,0,1,1]
  ],

  "8": [
    [1,1,1,0,0,0],
    [1,1,1,1,0,0],
    [1,1,1,1,1,0],
    [0,1,1,1,1,1],
    [0,0,1,1,1,1],
    [0,0,0,1,1,1]
  ],

  "9": [
    [1,1,1,1,1,1],
    [0,1,1,1,1,0],
    [0,0,1,1,0,0],
    [0,0,1,1,0,0],
    [0,1,1,1,1,0],
    [1,1,1,1,1,1]
  ],

  "10": [
    [1,1,1,1,0,0],
    [1,1,1,1,1,0],
    [0,1,1,1,1,1],
    [1,1,1,1,1,0],
    [1,1,1,1,0,0],
    [0,1,1,0,0,0]
  ]
}
